########
#._.*__#
##$_*__#
##__*_*#
##_*__.#
#_$$**$#
#@.____#
########
