########
#._.@__#
#$$$*$*#
#._$___#
#.$.*_*#
#_$.$__#
#._.*__#
########
