########
#......#
#------#
#*****-#
#------#
#$$$$$$#
#-----@#
########
