########
#.....-#
#--##--#
#-*----#
#--#-#-#
#$$$$$$#
#-----+#
########
