########
#.O.O..#
#####OO#
#.@$OO$#
#$O$O$O#
#OO$O$O#
#.$OO..#
########
