########
#......#
#.OOO$@#
#.O$OO$#
#$O$O$O#
#O$$O$O#
#.$OOO.#
########
