########
#.OOOOO#
#$O$O$O#
#OO$O$O#
#@O$O$O#
###***O#
#......#
########

########
#.O$OO.#
#O$..$O#
#$$..$O#
#O$..$$#
#@$O.$O#
#..$OO.#
########

########
#.O$OO.#
#O$..$O#
#$$..$O#
#O$..$$#
#@$..$O#
#.O$OO.#
########

########
#......#
###***O#
#@O$O$O#
#OO$O$O#
#$O$O$O#
#.OOOOO#
########

########
#.....O#
#$$$$$O#
#OO...O#
#$$$$$O#
#O.OO$.#
#.O$.$+#
########

########
#......#
###***O#
#@O$O$O#
#OO$O$O#
#OO$O$O#
#OOOOOO#
########

########
#.$.$OO#
#@OOOOO#
#O$$$$$#
#O.....#
#$$$$$$#
#......#
########

########
#.OOO.O#
#@$O##O#
#OOO*OO#
#.$O$O$#
#$$$$..#
#...OOO#
########

########
#OOOO.O#
#@OO##O#
#OOO*OO#
#.$O$OO#
#$$$$.O#
#...OOO#
########

#######
#@$OO.#
#$O$OO#
#.O.OO#
#######

########
#..... #
#$$$$$@#
# .....#
#$$$$$$#
#    $.#
#. $.$.#
########

########
#.....O#
#$$$$$O#
#OO...O#
#$$$$$O#
#O.OO$.#
#.O$.$+#
########
